##########################
#         #
#         #
#         #
##############    ########
#                        #
#          0
#
#                        #
##########################