###############################
#   X        X                #
#     0                       #
#           X                 #
#                             #
#  X                          #
#             X               #
#                             #
#                             #
#                             #
#                             #
#                             #
#                             #
#                             #
#                             #
#                             #
#                             #
###############################