##########################
#                        #
#                        #
#                     #
##############    ########
#                        #
#
#
#                        #
##########################